20
. . . . . + . . O . . . . . . . + . . .
. . . . . . . . . . . . . . . . . . . .
. . . . . . . . . . . . . . . . . . . .
. . . . @ . . . . . . . . . . . . . . .
. . . . . . . . . . . . . . . . . . . .
.     +       +   . . . . . . . . . . .
.     +       +   . . . . . . . . . . .
. . . . . . . + + + . . . . . . . . . .
. . . . . . . . . + . . . . . . . . . .
. . . . . . . + + + + + + + . . . . . .
. . . . . . . . . + . . . . . . . . . .
. . . . . . . . . + . . . . . . . . . .
. . . . . . . . . + + + + + + . . . . .
. . . . . . . . . . . . . . + . . . . .
. . . . . . . . . . . . . . + . . . . .
. . . . . . . . . . + + + + + + + + + +
. . . . . . . . . . + . . . . . . . . +
. . . . . . . + + + + . . . . . . . . +
. . . . . . . . . . . . . . . . . . . +
. . . . . . . . . . . . . . . . . . . .