20
          . . . . O . . . . . . + . . .
+ + + +   . . . . . . . . . . . . . . .
+     +   . . . . . . . . . . . . . . .
+ +   +     . @ .                     +
  +   +     . . .                     +
  +   +       +     . . . . . . . .   .
+ +   +       +       . . . .     .   .
+     +       + + +         .     .   .
+     +           +         . . . .   .
+     +       + + + + + + .   . .     .
+     +       +                       +
  + + + + + + +                       #
              +   + + + + + +       . .
. . . . . .   +             +       . #
. . . . . .   +             +       . #
. . . . . .   .     + + + + + + + + + +
. . . . . .   .     +                 +
. . . . . .   + + + +                 +
. . . . . .                           +
. . . . . . . + + + + + + + + + + + + +