20
. . . . . + . . . O . . . . . . + . . .
. . . . . . . . . . . . . . . . . . . .
. . . . . . . . . . . . . . . . . . . .
. . . . . . . @ .                     +
. . . . . . . . .                     +
.     +       +     . . . . . . . .   .
      +       +       . . . .     .   .
. . . . . .   + + +         .     .   .
. . . . . .       +         . . . .   .
. . . . . .   + + + + + + .   . .     .
. . . . . .       +                   +
. . . . . .       +                   #
. . . . . .       + + + + + +       . .
. . . . . .                 +       . #
. . . . . .                 +       . #
. . . . . .   .     + + + + + + + + + +
. . . . . .   .     +                 +
. . . . . .   + + + +                 +
. . . . . .                           +
. . . . . .                           +