20
. . . . . + . . . O . . . . . . + . . .
+ + + + . . . . . . . . . . . . . . . .
+     + . . . . . . . . . . . . . . . .
+     + . . . @ .                     +
      + . . . . .                     +
      +       +     . . . . . . . .   .
      +       +       . . . .     .   .
      +       + + +         .     .   .
      +           +         . . . .   .
      +       + + + + + + +   . .     .
      +          +                    +
  + + + + + + +   +                   #
.             +   + + + + + +       . .
. . . . . .   +             +       . #
. . . . . .   +             +       . #
. . . . . .   .     + + + + + + + + + +
. . . . . .   .     +                 +
. . . . . .   + + + +                 +
. . . . . .   .                       +
. . . . . .   .                       +