10
. . . . . . . . . .
. . . . . . . . . .
. . . . . A . . . .
. . . .     . . . .
. . . .     . . . .
. . . .     . . . .
. . . . . . . . . .
. . . . . . . . . .
. . . . @ . . .   .
. . . . . . . . . .
