20
. . . . . + . . . O . . . . . . + . . .
. . . . . . . . . . . . . . . . . . . .
. . . . . . . . . . . . . . . . . . . .
. . . . . . . @ .                     +
. . . . . . . . .                     +
.     +       +     . . . . . . . .   .
      +       +       . . . .     .   .
. . . . . .   + + +         .     .   .
. . . . . .       +         . . . .   .
. .           + + + + + + +   . .     .
. .               +                   +
. . + + + + + +   +                   #
. . . . . .   +   + + + + + +       . .
. . . . . .   +             +       . #
. . . . . .   +             +       . #
. . . . . .   .     + + + + + + + + + +
. . . . . .   .     +                 +
. . . . . .   + + + +                 +
. . . . . .   .                       +
. . . . . .   .                       +