20
          . . . . O . . . . . . + . . .
+ + + +   . . . . . . . . . . . . . . .
+     +   . . . . . . . . . . . . . . .
+ +   +     . @ .                     +
  +   + . . . . .                     +
  +   +       +     . . . . . . . .   .
+ +   +       +       . . . .     .   .
+     +       + + +         .     .   .
+     +           +         . . . .   .
+     +       + + + + + + +   . .     .
+     +                               +
  + + + + + + +                       #
              +   + + + + + +       . .
. . . . . .   +             +       . #
. . . . . .   +             +       . #
. . . . . .   .     + + + + + + + + + +
. . . . . .   .     +                 +
. . . . . .   + + + +                 +
. . . . . .                           +
. . . . . . . . + + + + + + + + + + + +