20
. . . . . + . . . O . . . . . . + . . .
. . . . . . . . . . . . . . . . . . . .
. . . . . . . . . . . . . . . . . . . .
. . . . . . . @ .                     +
. . . . . . . . .                     +
.     +       +     . . . . . . . .   .
      +       +       . . . .     .   .
. . . . . .   + + +         .     .   .
. . . . . .       +         . . . .   .
. . . . . .   + + + + + + +   . .     .
. . . . . .       +                   +
. . . . . .       +                   .
. . . . . .       + + + + + +       . .
.       . .                 +       . #
.       . .                 +       . #
. . . . . .   .     + + + + + + + + + +
. . . . . .   .     +                 +
. . . . . .   + + + +                 +
. . . . . .                           +
. . . . . .                           +