20
. . . . . + . . . O . . . . . . + . . .
. . . . . . . . . . . . . . . . . . . .
. . . . . . . . . . . . . . . . . . . .
. . . . . . . @ .                     +
. . . . . . . . .                     +
.     +       +     . . . . . . . .   .
      +       +       . . . .     .   .
      +       + + +         .     .   .
      +           +         . . . .   .
  + + +       + + + + + + +   . .     .
  +               +                   +
  + + + + + + +   +                   #
.             +   + + + + + +       . .
. . . . . .   +             +       . #
. . . . . .   +             +       . #
. . . . . .   .     + + + + + + + + + +
. . . . . .   .     +                 +
. . . . . .   + + + +                 +
. . . . . .   .                       +
. . . . . .   .                       +